-------------M-----------
-------------------------
-------------------------
-------------------------
-------------------------
-------------------------
-------------------------
-------------------------
-------------------------
------------------S------
-------------------------
-------------------------
-------------------------
-H-----------------------
BBBBBBBBBBBBBBBBBBBBBBBBB
