-------------------------
------BBBBBBBBBBBBB------
----------------------M--
---M----------------BBBB-
--BBBBB------------------
-------------------------
----------------BB-------
-------------------------
-----------------BBBB----
----------------B--------
---BBBBB-------B---------
------------BBBB---------
-------------------------
-H--------------------M--
BBBBBBBBBBBBBBBBBBBBBBBBB
