-------------------------
-------------------------
------BBBBBBBB-----------
-----------------BBBBBBB-
-------------------------
----BBBBBB---------------
--------------BBB--------
-------------------------
-------------------------
---------M---------------
------BBBBBBBB-------BBB-
--------------BBBB----
-------------------------
-H------B------------M---
BBBBBBBBBBBBBBBBBBBBBBBBB
