-------------------------
------BBB---BBB----------
-------------------------
---M----------------BBBB-
--BBBBB------------------
-------------------------
----------------BB-------
-------------------------
--------BBBBBB-----BB----
-------------------------
-------------------------
------------BBBB---------
-------------------------
-H--------------------M--
BBBBBBBBBBBBBBBBBBBBBBBBB
